3  ##### 
###   #
#.@$  #
### $.#
#.##$ #
# # . ##
#$  $$.#
#   .  #
########

