4            ########
            #  ....#
#############  ....#
#     #  $ $   ....#
#  $$$#$  $ #  ....#
#   $     $ #  ....#
#  $$ #$ $ $########
#   $ #     #
## ##########
#     #    ##
#      $ @ ##
#   $$#$$   #
#     #    ##
############