######################################################################
#                                                                    #
#    ##########             #########               ##########       #
#    #        #             #       #               #        #       #
#    #   $    ##########    #   .   #######   #######   $    #       #
#    #   @                ####   ####     #   #     ####     #       #
#    ########   #######   #       #       #   #         #    #       #
#            #  #     #   #   $   #   .   #   #   $     #    #       #
#   ######   #  # .   #####       #       #####   #######    #       #
#   #    #   #  #         #########   #########              #       #
#   # $  #####  ######                    .   ######   #######       #
#   #                #   #######   ######       #   #   #            #
#   ###########   ####   #     #   #    ######  #   #####   ######## #
#             #   #      #  $  #   # .        # #                 .# #
#   #######   #   #   ####     #####    $     # #####   ###########  #
#   #     #####   #   #              ######   #     #   #            #
#   #  .        . #   #   #######          #   #     #####   ####### #
#   #######   #####   #   #     #   ####   #####         #   #     # #
#         #   #       #   # $   #   #  #       #   $     #   # .   # #
#   ##### #   #   #########     #####  ######  ###########   ####### #
#   #   # #   #             ###       ##    ##              .        #
#   # $ # #####   #######   #   #######  .   #########   ########### #
#   #   #     #   #     #   #   #     #########     #   #            #
#   #######   #####  $  #   #####   $          $   #####   #######   #
#        .#         .    .     #                .     #   #     #   #
#   #######   ###########   ####   ########   ######  #####  $  #   #
#   #        .#         #       #  #      #   #    #       #     #   #
#   #   ########   #    ######  ####  $   #####    ######  #######   #
#   #   #      #   #         #      #   #     #          #          #
#   #####  $   #   ###########   ####   #####   ##########   #########
#       #      #               .#    $      #  .#      .   .#        #
#   #######    #####   #######   ########   #####   ###########   ####
#   #     #        #   #     #   #      #       #   #         #      #
#   #  $  ######   ##### $   #   #   $  ######  #   #   $     ########
#   #             .     #     . #       #    #  #   #       .        #
#   #######   ###########   ##########  #    #  #######   #########  #
#   #     #   #         #   #        #  #    #        #           #  #
#   #  $  #####   ###   #####   $    #  ######   $    #####   $   #  #
#   #            #.#        #   .    #       #   .        #   .   #  #
#   ############## ##########   ########### ###########   #########  #
#                                                                    #
#                                                                    #
#    ##########             #########               ##########       #
#    #        #             #       #               #        #       #
#    #   $    ##########    #   .   #######   #######   $    #       #
#    #                     ####   ####     #   #     ####     #      #
#    ########   #######   #       #       #   #         #    #       #
#            #  #     #   #   $   #   .   #   #   $     #    #       #
#   ######   #  # .   #####       #       #####   #######    #       #
#   #    #   #  #         #########   #########              #       #
#   # $  #####  ######                    .   ######   #######       #
#   #                #   #######   ######       #   #   #            #
#   ###########   ####   #     #   #    ######  #   #####   ######## #
#             #   #      #  $  #   # .        # #                 .# #
#   #######   #   #   ####     #####    $     # #####   ###########  #
#   #     #####   #   #              ######   #     #   #            #
#   #  .        . #   #   #######          #   #     #####   ####### #
#   #######   #####   #   #     #   ####   #####         #   #     # #
#         #   #       #   # $   #   #  #       #   $     #   # .   # #
#   ##### #   #   #########     #####  ######  ###########   ####### #
#   #   # #   #             ###       ##    ##              .        #
#   # $ # #####   #######   #   #######  .   #########   ########### #
#   #   #     #   #     #   #   #     #########     #   #            #
#   #######   #####  $  #   #####   $          $   #####   #######   #
#        .#         .    .     #                .     #   #     #   #
######################################################################