5#####
#@  #
# $ #
### #
#.$ #
#  .#
#####