2 ####### 
 # @...# 
 #   ####
## $    #
#   #$# #
# $ #   #
#   #####
#####