1  ##### 
###   # 
#!    # 
###@$.# 
#.##$ # 
# # . ##
#$  $$.#
#   .  #
########
        
